11111111111111111111111111110000000000000011111111111110001111111111111111111111111111111111111111110000001111111111111111111111
01222211222211111011111111000000000000001111222222221100001111111111111111111111111222211111111111110000111111111112222112222111
11222212211221111111111100000000000000001112211221122100000011111111111111111111111222211221111111110000111111111122112212222111
11111111111111111111111100000000000000001111111111111111000011111111111111111111111111111122111111110000111111111111111111111111
11221111111111111111111111000000000000001111111111111111000001111111111111111111111111111112211111111100011111111111111111122111
12211111111111111111111111000000000000002222111111111111000001111111111111111111111111111111111111111100001111111111111111112211
11111111111111111111111111000000000000112222111111111111110011001111111111111111111111111112211111111100001111111111111111111111
12211111111111111111111111000000000000111111111111111111111110000011111111111111111111111122111111111100001111111111111111112211
11221111111111111111111100000000000000001111111111111111111100000000111111111111111111111112211111111100001111111111111111122111
11111111111111111111111100000000000000001111111111111111111100000000111111111111111111111122111111111100001111111111111111111111
11111111111111111111111100000000000000001111111111111111111111000000111111111111111111111111111111111100001111111111111111111111
11111111111111111111111100000000000000000011111111111111111111000000111111111111111111111122111111111100001111111111221111111111
11111111111111111111111111000000000000000000111111111111111111100011111111111111111111111221111111110000001111111111111111111111
11111111111111111111111100010000000000000000111111111111111111000011111111111111111111111111111111110000111111111111111111111111
11111111111111111111111100000000000000000000111111111111111111000000111111111111111111111111111111110000111111111111111111111111
11111111111111111111111100000000000000000000111111111111111111110000001111111111111111111111111111110000111111111111111111111111
11111111111111111111111110110000000000000000111111111111111111100000001111111111111111111111111111111100011111111111111111111111
11111111111111111111111111110000000000000000000011111111111111000000111111111111111111111111111111111100001111111111111111111111
11111111111111111111111111111100000000000000000000111111111111000000111111111111111111111111111111110000001111111111111111111111
11111111111111111111111111111111000000000000000000011111111111110000001111111111111111111111111111000000111111111111111111111111
11111111111111111111111111111111110000000000000000001111111111110000000011111111111111111111111100000011111111111111111111111111
11111111111111111111111111111111111100000000000000001111111111110000000011111111111111111111110000001111111111111111111111111111
11111111111111111111111111111111111100000000000011111111111111111110001111111111111111111111000000001111111111111111110000000011
11111111111111111111111111111111111110000000000011111111111111111100001111111111111111111111000011001111111111111000000000000000
11111111111111111111111111111111111111111111111111111111111111111100000011111111111111111111000000111111111111110000001111111100
11111111111111111111111111111111111111111111111111111111111111111111000011111111111111111100000000000000111100000000001111111111
11111111111111111111111111111111111111111111111111111111111111111111000011111111111111110000000000000000000000000000001111111111
11111111111111111111111111111111111111111111111111111111111111111111000000000011110000000000111100000000000011110000111111111111
11111111111111111111111111111111111111111111111111111111111111111111110000000000000000000011111111000000000011111111111111111111
11111111111111111111111111111111111111111111111111111111111111111111111100000000000000002211111111111111000011111111111111111111
11111111111111111111111111111111111111111111111111111111111111111111111111111100001111111222211111111111000011111111111111111111
11111111111111111111111111111111111111111111111111111111111111111111111111111111111111111111111111111111000011111111111111111111
11111111111111111111111111111111111111111111111111111111111111111111111111111111111111111111112211111110001111111111111111111111
11111111111111111111111111111111111111111111111111111111111111111111111111111111111111111111111111111100001111111111111111111111
11111111111100111111111111111111111111111111111111111111111111111111111111111111111111111111122111000000001111111111111111111111
00111111110000011111111111111111111111111111111111111111111111111111111111111111111111111111112200000000111111111111122221111111
00111111110000001111111111111111111111111111111111111111111111111111111111111111111111111111111000111111111111111111122221122111
00000000000000001111111111111111111111111111111111111111111111111111111111111111111111111111110000111111111111111111111111112211
00000000000000111111111111111111111111111111111111111111111111111100111111111111111111111111110000111111111111111111111111111221
00000000000000001111111111111111111111111111111111111111111111111100111111111111111111111111110000111111111111111111111111112211
00000000000000000111111111111111111111111111111111111111111111111100111111111111111111111111110000111111111111111111111111111111
00000000000000000011111111111111111111111111111101111111111111111111111111111111101111111111110000111111111111111111111111112211
00000000000000000011111111111111111111111111111111111111111111111111111111111111111111111111110000111111111111111111111111111221
00000000000000000011111111111111111111111111111111111111111111111111111111111111111111111111100011111111111111111111111111111111
00000000000000000011111111111111111111111111111111111111111111111111111111111111111111111111000011111111111111111111111111111221
00000000000000000001111111111111111111111111111111111111111111111111111111111111111111111111000011111111111111111111111111112211
00000000000000000000111111111111111111111111111111111111111111111111111111111111111111111111000011111111111111111111111111122111
00000000000000000000111111111111111111111111111111111100111111111111111111111111111111111111000011111111111111111111111111111111
00000000000000000000111111111111111111111111111111111111111111111111111111111100111111111111000011111111111111111111111111111111
00000000000000000000111111111111111111111111111111111111111111111111111111111100111111111111000000111111111111111111111111111111
00000000000000000000011111111111111111111111111111111111111111111111111111111100111111111111110000111111111111111111111111111111
00001111000011110000001111111111111111111111111111111111111111111111111011111111111111111111010000111111111111111111111111111111
00111222211111110000001111111111111111111111111111111111111111111111111111111111111111111111110000001111111111111111111111111111
11111222211111110000000111111111111111111111111111101111111111111111111111111111111111111111111100000011111111111111111111111111
11111111111111111100000011111111111111111111111111111111111111111111111111111111111111111111111111000011111111111111111111111111
11111111111111111100000011111111111111111111111111111111111111111111111111111111111111111111111111000011111111111111111111111111
12211111111111111100000011111111111111111111111111111111111111111111111111111111111111111110111111000000000000001111111111111111
11221111111111111111100011111111111111111111111111111111111111111111111111111111111111111111111111110000000000000000000111111111
12211111111111111111000011111111111111111111111111111111111111111111111111111111111111111111111111111100000000000000000111111111
11221111111111111111000011111111111111111111111111111111111111111111111111111111111111111111111111111111111111110000001100111111
11221111111111111111111111111111111011111111111111111111111111111111111111111100001111111111111111111111111111111111111000001111
12211111111111111111111111111111111111111111111111111111111111111111111111111100001111111111111111111111111111111111110000000000
11221111111111111111111111111111111111111111111111111111111111111111111111111100001111111111111111111111111111111111110000000000
11111111111111111111111111111111111111111111111111111111111111111111111111111111111111111111111111111111111111111111111111110000
11111111111111111111111111111111111111111111111111111111111111111111111111111111111111111111111111111111111111111111111111111111
00001111011111111111111111111111111100111111111111111111111111111111111111111111111111111111111111111111111111111111111111112211
00000000011111111111111111111111111111111111110000111111111111111111111111111111111111111111111111111111111111111111111111111221
11110000110001111111111111111111111111111111110000111111111111111111111111111111111111111111111111111111111111111111111111112211
11111111100011111111111111111111111111111111111000111111111111111111111111111111110011111111111111111111111111111111111111111221
11111111100000001111111111111111111111111111111111111111111111111111111111111111111111111111111111111111100011111111111111112211
11111111110000000000000000111111111111111111111111111111111111111111111111111111111111111111111111111111000001111111111111111221
11111111111111110000000000001111111111111111111111111111111111111111111111111111111111110111111111111111000000111111111111111221
11111111111111111111111111000111111111111111111111111111111111111111111111111111111111111111111111111111000000111111112222111111
11111111111111111111111111000011111111111111111111111111111111111111111111111111111111111111111111111111000011111111112222111111
11111111111111111111111111000011111111111111111111111111111111111111111111111111111111111111111111111111000000111111111111111111
11111111111111111111111111110000111111111111111111111111111111111111111111111111111111111111111111111111000000011111111111111111
11111111111111111111111111111100011111111111111111111111111111111111111111111111111111111111111111111111110000001111111111110000
11111111111111111111111111111100001111111111111111111111111111111111111111111111111111111111111111111111110000001100000000000000
11111111111111111111111111111100001111111111111111001111111111111111111111111111111111111111111111111111110000000000000000000000
11111111111111111111111111111111000111111111111111001111111111111111111111111111111111111111111111111111111100000000000000000000
11111111111111111111111111111111000011111111111111001111111111111111111100111111111111111111111111111111111100000000000000000000
11111122221111111111111111111111000011111111001111111111111111111111111111111111111111111111111111111111111100000000000000000000
11111122221111111111111111111111000011111111111111111111111111111111111111111111111111111111111111111111111111000000000000000000
11111111111111111111111111111111000011111111111111111111111111111111111111111111111111111111111111111111111111000000000000000000
11221111111111111111111111111111000011111111111111111111111111111111111111111111111111111111111111111111111111000000000000000000
12211111111111111111111111111100000011111111111111111111111111111111111111111111111111111111111111111111111110000000000000000000
11221111111111111111111111111100001111111111111111111111111111111111111111111111111111111111111111111111111100000000000000000000
12211111111111111111111111111100001111111111111111111111111111111111111111111111111111111111111111111111111100000000000000000000
11111111111111111111111111111100001111111111111111111111001111111111111111111111111111111111111111111111111111000000000000000000
12211111111111111111111111111100001111111111111111111111001111111111111111111111111111111111111111111111111111110000000000000000
11221111111111111111111111111100001111111111111111111111001111111111111111111111111111111111111111111111111111111100000000110001
11221111111111111111111111111100001111111111111111111111111111111111111111111111111111111111111111111111111111110000001100000000
11122221111111111111111100000000001111111111111111111111111111111111111111111111111111111111111111111111111111110000001100110000
11111111111111111111110000000000111111111111111111111111111111111111111111111111111111111111111111111111111111111000111100001011
11111111111111111111110000000012211111111111111111111111111111111111111111111111111111111111111111111111111111111111111111111111
11111111111111111111110000111111111111111111111111111111111111111111111111111111111111111111111111111111111111111111111111111111
11111111111111111111000000111122111111111111111111111111111111111111111111111111111111111111111111111111111111111111111111111111
11111111111111111111000000111112211111111111111111111111111111111111111111111111111111111111111111111111111111111111111111111111
11111111111111111111000000111111111111111111110000111111111111111111111111111111111111111111111111111111111111111111111111111111
11111111111111111111000011111111112211220000000000000000111111111111111111111111111111111111111111111111111111111111111111111111
11111111111100001111000000000011111221000000001111000000001111111111111111111111111111111111111111111111111111111111111111111111
11111111110000000000000000000000111100001111111111111111000111111111111111111111111111111111111111111111111111111111111111111111
00001111110000000000000000000000000000111111111111111111000011111111111111111111111111111111111111111111111111111111111111111111
00000011110000010000111100000000000011111111111111111111000011111111111111111111111111111111111111111111111111111111111111111111
00000000000000001111111111110000000011111111111111111111110001111111111111111100000000000111111111111111111111111111111111111111
11110000000000001111111111110011000011111111111111111111110000111111111110000000000000000011111111111111111111111111111111111111
11111100001111111111111111111100001111111111111111111111000000111111111100000000000000000011111111111111111111111111111111111111
11111111111111111111111111110000111111111111111111111111000011111111111100000000000000000011111111111111111111111111111111111111
11111111111111111111111111000011111111111111111111111111110001111111111111000000000000000000111111111111111111111111111111111111
11111111111111111111111100001111111111111111111111111111110000111111111111111111000000000000001111111111111111111111111111111111
11111111111111111111111000111111111111111111111111111111110000111111111111111111110000000000000011111111111111111111111111111111
11111111111111111111110000111111111111111111111111111111110000111111111111111111110000000000000000111111111111111111111111111111
11111111111111111111110000001111111111111111111111111111110000111111111111111111110000000000000000001111111111111111111111111111
11111111111111111111111100001111111111111111111111111111111100001111111111111111111100000000000000001111111111111111111111111111
11111111111111111111111100001111111111111122221111111111111111000111111111111111111100000000000000001111111111111111111111111111
11111111111111111111111100001111111111221122221111111111111111000011111111111111111100000000000000001111111111111111111111111111
11111111122111111111111000111111111112211111111111111111111100000011111111111111111111000000000000001111111111111111111111111111
11111111111111111111110000111111111122111111111111111111111100001111111111111111111111000000000000000011111111111111111111111111
11221111111111111111110000111111111112211111111111111111111100001101111111111111111111000000000000000011111111111111111111112211
12211111111111111111110000111111111111111111111111111111111100000001111111111111112222000000000000000011111111111111111111111221
12211111111111111111110000111111111112211111111111111111111111000011000111111111112222000000000000000011111111111111111111111111
11221111111111111111110000111111111122111111111111111111111111111110001111111111111111000000000000001111111111111111111111111221
11111111111111111111110000111111111112211111111111111111111111111110001111111111111111000000000000000011111111111111111111112211
12222122112211111111110000111111111111111111111111111111111111111111000111111111112211000000000000000011111111111111111111111111
12222112222111111111110000001111111112211111111111111111111111111111000011221221122100000000000000000000111111111112211221222211
11111111111111111111110000001111111111221111111111111111111111111111000011112222221100000000000000000000111101111111222211222211
00000111111111111111110000001111111111111111111111111111111111111111110000111111111100000000000000000011110011111111111111100000
00000000000000000000000000000000000000000000000000000000000000000000000000000000000000000000000000000000000000000000000000000000
