11111111111111111111111111111111111111110000000000000000001111222211110000000000000000011111111111111111111111111111111111110000
11111112222111111111111111111111111111111000000000000000111221222212211100000000000000011111111111111111111111111111111111110000
11111112222111111111111111111111111111110000000000000000111111111111111100000000000000001111111111111111111111111111122221111111
11221111111111111111111111111111111111111000000000000000122111111111122100000000000000011111111111111111111111111111122221111111
11111111111111111111111111111111111111110000000000000000111111111111111100000000000000001111111111111111111111111111111111112211
11221111111111111111111111111111111111000000000000000000122111111111122100000000000000000011111111111111111111111111111111111221
12211111111111111111111111111111111111100000000000000000111111111111111100000000000000000111111111111111111111111111111111112211
11221111111111111111111111111111111111111000000000000011111111111111111111000000000000011111111111111111111111111111111111111221
11221111111111111111111111111111111111111110000000000011111111111111111111000000000001111111111111111111111111111111111111111221
12211111111111111111111111111111111111111111100000000000111111111111111100000000000011111111111111111111111111111111111111112211
11221111111111111111111111111111111111111111100000000000001111122111110000000000000011111111111111111111111111111111111111111111
11221111111111111111110000000011111111111111100000000000000011111111000000000000000111111111111111000000001111111111111111112211
11122111111111111111000000000000111111111111000000000000000000111100000000000000000011111111111100000000000011111111111111112211
11111111111111111100000000000000001111111111100000000000000000000000000000000000000111111111110000000000000000111111111111122111
11111111111111110000001111111100000011111111100000000000000000000000000000000000000111111111000000111111110000001111111111111111
11111111111111000000111111111111000001111111100000000000000000000000000000000000000111111100000011111111111100000111111111111111
11111111111111100011122122221111110001111111100000000000000000000000000000000000000011111110001111111222222111000111111111111111
11111111111111100011221221122111110000111111100000000000000000000000000000000000000111111110001111122122112211000111111111111111
11111111111111100011111111112211110001111111111000000000000000000000000000000000011111111110001111221111111111000111111111111111
11111111111111100011111111112211110000111111111110000000000000000000000000000000111111111100001111221111111111000011111111111111
11111111111111100011111111111111110001111111111111000000000000000000000000000011111111111110001111111111111111000111111111111111
11111111111111000011111111111111110001111111111111110000000000000000000000001111111111111100001111111111111111000011111111111111
11111111111100000011111111112222110001111111111111111100000000000000000000111111111111111110001122221111111111000000111111111111
11111111110000001111111111112222000011111111111111111110000000000000000001111111111111111111100022221111111111110000001111111111
11111111111000111111111111111100001111111111111111111110000000000000000001111111111111111111110000111111111111111100011111111111
11111111110000111111111111111100001111111111111111111000000000000000000000011111111111111111110000111111111111111100001111111111
11111111111000111111111111111100000011111111111111110000000010011101000000001111111111111111000000111111111111111100011111111111
11111111110000110011111111111111000000111111111111000000111100111100111100000011111111111100000011111111111111001100001111111111
11111111111000000111101111111111110000001111111100000011111111111111111100000000111111110000001111111111110111100000011111111111
11111111111100011110001111111111111100000011110000001111111111111111111111110000001111000000111111111111110001111001111111111111
11111111111111111000011111111111111111000000000000111111111111111111111111111100000000000011111111111111111000011111111111111111
11111111111111111000111111111111111111110000000011111111111111111111111111111111000000001111111111111111111100011111111111111111
11111111111111111110001111111111111111111100000111111111111111111111111111111111010000111111111111111111110001111111111111111111
11111111111111111111100011111111111111111111111111111111111111111111111111111111111111111111111111111111000111111111111111111111
11111111111111111111110000111111111111111111111111111111111111111111111111111111111111111111111111111100001111111111111111111111
11111111111111111111111110001111111111111111111111111111111111111111111111111111111111111111111111110001111111111111111111111111
11111111111111111111111110001111111111111111111111111111111111111111111111111111111111111111111111110001111111111111111111111111
11111111111111111111111110001111111111111111111111111111111111111111111111111111111111111111111111110001111111111111111111111111
11111111111111111111111100001111111111111111111111111111111111111111111111111111111111111111111111110000111111111111111111111111
00111111111111111111111110000011111111111111111111111111111111001111111111111111111111111111111111000001111111111111111111111100
00011111111111111111111110000011111111111111111111111111111111111111111111111111111111111111111111000000111111111111111111110000
00000011111111111111111110000011111111111111111111111111111111111111111111111111111111111111111111000001111111111111111111000000
00000000111111111111111100000011111111111111111111111111111111111111111111111111111111111111111111000000111111111111111110000000
00000000001112211221220000000011111111111111111111111111111111111111111111111111111111111111111111100000002212211221110000000000
00000000000011221122000000111111111111111111111111111111111111111111111111111111111111111111111111111100000022112211000000000000
00000000000000000000000011111111111111111111111111111111111111111111111111111111111111111111111111111111000000000000000000000000
00000000000000000000001111111111111111111111111111111111111111111111111111111111111111111111111111111111110000000000000000000000
00000000000000000000111111111111111111111111111111111111111111111111111111111111111111111111111111111111111100000000000000000000
00000000000000001111111111111111111111111111111111111111111111111111111111111111111111111111111111111111111111110000000000000000
00000000000000001111111111111111111111111111111111111111111111111111111111111111111111111111111111111111111111110000000000000000
00000000000000001111111111111111111111111111111111111111111110000011111111111111111111111111111111111111111111110000000000000000
00000000000000001111111111111111111111111111111111111111000000100100000011111111111111111111111111111111111111110000000000000000
00000000000000111111111111111111111111111111111111111111000110000001100011111111111111111111111111111111111111111100000000000000
00000000000001111111111111111111111111111111111111111111000000000000000011111111111111111111111111111111111111111110000000000000
00000000000000111111111111111111111111111111111111111111110000111100001111111111111111111111111111111111111111111100000000000000
00000000000000001111111111111111111111111111111111111111111111111111111111111111111111111111111111111111111111110000000000000000
00000011110000000011111111111111111111111111111111111111111111111111111111111111111111111111111111111111111111000000001111000000
00111111111100000000111111111111111111111111000011111111111111111111111111111111000011111111111111111111111100000000111111111100
11111221111111000000111111111111111111111111000100111111111111222211111111111100100011111111111111111111111100000011111122111111
11122122111111110000111111111111111100111111000000111111112211222211221111111100000011111100111111111111111100001111112212211111
11221111111111110000111111111111111111111111000000111111111111111111111111111100000111111111111111111111111100001111111111112211
11111111111111110000111111111111111111111111001000111111111111111111111111111100010011111111111111111111111100001111111111111111
11111111111111111111111111111111111111111111000000111111221111111111112211111100000011111111111111111111111111111111111111111111
22221111111111111111111111111111111111111111000000111111111111111111111111111111000011111111111111111111111111111111111111112222
22221111111111111111111111111111111111111111000000111111111111111111111111111100000011111111111111111111111111111111111111112222
11111111111111111111111111111111111111111111000011111111111111111111111111111100000011111111111111111111111111111111111111111111
11111111111111111111111111111111111111111111000100111111221111111111112211111100100011111111111111111111111111111111111111111111
11221111111111110000111111111111111111111111000000111111111111111111111111111100000011111111111111111111111100001111111111112211
11111111111111110000111111111111111100111111100000111111111111111111111111111100000011111100111111111111111100001111111111111111
11122221111111110000111111111111111111111111001000111111112211222211221111111100010011111111111111111111111100001111111122122111
11111122111111000000111111111111111111111111000000111111111111222211111111111100000011111111111111111111111100000011111112211111
00111111111100000000111111111111111111111111000011111111111111111111111111111111000011111111111111111111111100000000111111111100
00000011110000000011111111111111111111111111111111111111111111111111111111111111111111111111111111111111111111000000001111000000
00000000000000001111111111111111111111111111111111111111111111111111111111111111111111111111111111111111111111110000000000000000
00000000000000001111111111111111111111111111111111111111110000111000001111111111111111111111111111111111111111110000000000000000
00000000000000001111111111111111111111111111111111111111001001000010010011111111111111111111111111111111111111110000000000000000
00000000000000001111111111111111111111111111111111111111000000011000000011111111111111111111111111111111111111110000000000000000
00000000000000001111111111111111111111111111111111111111000000000000000011111111111111111111111111111111111111110000000000000000
00000000000000001111111111111111111111111111111111111111111111000011111111111111111111111111111111111111111111110000000000000000
00000000000000001111111111111111111111111111111111111111111111111111111111111111111111111111111111111111111111110000000000000000
00000000000000000010111111111111111111111111111111111111111111111111111111111111111111111111111111111111111101000000000000000000
00000000000000000000011111111111111111111111111111111111111111111111111111111111111111111111111111111111110100000000000000000000
00000000000001100110000111111111111111111111111111111111111111111111111111111111111111111111111111111111000000100010000000000000
00000000000011221122000011111111111111111111111111111111111111111111111111111111111111111111111111111111000122112211100000000000
00000000001112211221221000111111111111111111111111111111111111111111111111111111111111111111111111111100012212211221111000000000
00000001111111111111111110000011111111011111111111111111111111111111111111111111111111111111111111000001111111111111111110000000
00000011111111111111111100000011111111111111111111111111111111111111111111111111111111111111111111000001111111111111111111100000
00011111111111111111111110000011111111111111111111111111111111111111111111111111111111111111111111000001111111111111111111111000
01111111111111111111111110000011111111111111111111111111111111110011111111111111111111111111111111000000111111111111111111111100
11111111111111111111111110000111111111111111111111111111111111111111111111111111111111111111111111100001111111111111111111111111
11111111111111111111111100001111111111111111111111111111111111111111111111111111111111111111111111110000111111111111111111111111
11111111111111111111111110001111111111111111111111111111111111111111111111111111111111111111111111110001111111111111111111111111
11111111111111111111111100001111111111111111111111111111111111111111111111111111111111111111111111110000111111111111111111111111
11111111111111111111110000001111111111111111111111111111111111111111111111111111111111111111111111110000001111111111111111111111
11111111111111111111000000111111111111111111111111111111111111111111111111111111111111111111111111111100000011111111111111111111
11111111111111111100000011111111111111111111111111111111111111111111111111111111111111111111111111111111000000111111111111111111
11111111111111111000001111111111111111111100001111111111111111111111111111111111110000111111111111111111110000011111111111111111
11111111111111111100011111111111111111110001100011111111111111111111111111111111000100001111111111111111111000111111111111111111
11111111111100001110001111111111111111000011110000011111111111111111111111111100001111000011111111111111110001110000111111111111
11111111111000000111111111111111111100001111111100001111111111111111111111110000111111110000111111111111111111100000011111111111
11111111111000000011111111111111110001111111111111000011111100111100111101000011111111111110001111111111111111000000011111111111
11111111110000111111111111111111000011111111111111110000110100011100101100011111111111111111000011111111111111111100001111111111
11111111111000111111111111111100001111111111111111111110000000000000000000111111111111111111110000111111111111111100011111111111
11111111111000111111111111111100001111111111111111111110000000000000000000111111111111111111110000111111111111111100001111111111
11111111111000111111111111111100000011111111111111111110000000000000000001111111111111111111000000111111111111111100011111111111
11111111111100001111111111112222000001111111111111111100000000000000000000111111111111111100000022221111111111110000111111111111
11111111111111000011111111112222110001111111111111110000000000000000000000001111111111111110001122221111111111000011111111111111
11111111111111000011111111111111110000111111111111000000000000000000000000000011111111111100001111111111111111000011111111111111
11111111111111100011111111111111110001111111111100000000000000000000000000000000111111111110001111111111111111000111111111111111
11111111111111000011111111112211110000111111110000000000000000000000000000000000001111111110001111221111111111000111111111111111
11111111111111100011111111112211110001111111100000000000000000000000000000000000000111111110001111221111111111000111111111111111
11111111111111100011221221122111110000111111100000000000000000000000000000000000000111111110001111122112212211000011111111111111
11111111111111100011112222221111110001111111000000000000000000000000000000000000000111111110001111112222221111000111111111111111
11111112222111111000111111111111000111111111100000000000000000000000000000000000000111111111000011111111111100001111111111111111
11111112222111111100001111111100001111111111100000000000000000000000000000000000000111111111110000111111110000111111122221111111
11221111111111111111100000000001111111111111100000000000000000000000000000000000000111111111111110000000000011111111122221111111
11221111111111111111110000000111111111111111000000000000000000122100000000000000000111111111111111000010001111111111111111111111
12211111111111111111111111111111111111111111100000000000000011111111000000000000000111111111111111111111111111111111111111112211
12211111111111111111111111111111111111111111000000000000001111111111110000000000000011111111111111111111111111111111111111111221
11111111111111111111111111111111111111111110000000000000111111111111111100000000000001111111111111111111111111111111111111111221
12211111111111111111111111111111111111110000000000000000111111111111111100000000000000001111111111111111111111111111111111112211
11221111111111111111111111111111111111100000000000000011111111111111111111000000000000000011111111111111111111111111111111111221
12211111111111111111111111111111111111100000000000000011122111111111122111000000000000000111111111111111111111111111111111111111
11221111111111111111111111111111111111110000000000000000111111111111111100000000000000001111111111111111111111111111111111112211
11122111111111111111111111111111111111110000000000000000122111111111122100000000000000011111111111111111111111111111111111112211
11111111111111111111111111111111111111111000000000000000111111222211111100000000000000011111111111111111111111111111111112222111
00000111111111111111111111111111111111110000000000000000111221222212211100000000000000001111111111111111111111111111111111100000
00000000000000000000000000000000000000000000000000000000000000000000000000000000000000000000000000000000000000000000000000000000
