000000000000000
211100111200000
011111111000000
001100000000000
001111100001122
000011111111100
000211100011100
000000000000000